 2  2  2  2  2  2  2  2  2  2  2  2  2  2  2  2  2  2  2  2  2  2  2  2  2  2  2  2  2  2  2  2  2  2  2  2  2  2  2  2  2  2  2  2  2  2  2  2  2  2
 2  2  2  2  2  2  2  2  2  2  2  2  2  2  3  2  2  2  2  2  2  2  2  2  2  2  2  2  2  2  2  2  2  2  2  2  2  2  2  2  2  2  2  2  2  2  2  2  2  2
 2  2  2  2  2  2  2  3  2  2  2  2  2  2  2  2  2  2  2  2  2  2  2  2  2  3  2  2  2  2  2  2  2  3  2  2  2  2  2  2  2  2  2  2  2  2  2  2  2  2
 2  2  2  2  3  2  2  2  2  2  2  3  2  2  2  2  2  2  3  2  2  2  2  2  2  2  2  3  2  2  2  2  2  2  2  2  2  2  2  2  2  3  2  2  2  2  2  2  2  2
 2  2  2  2  2  2  2  2  2  3  2  2  2  2  2  3  2  2  2  2  2  2  2  3  2  2  2  2  2  2  2  3  2  2  3  2  2  2  3  2  2  2  2  2  2  2  2  2  2  2
 2  2  2  2  2  2  2  2  2  2  2  2  2  2  2  2  2  2  2  2  2  3  2  2  2  2  2  2  2  3  2  2  2  2  2  2  3  2  2  2  2  2  2  3  2  2  2  2  2  2
 2  2  2  2  2  3 12 10 10 10 10 10 10 10 13  2  2  2 12 10 10 10 10 10 10 10 10 13  2  2  2 12 10 10 10 10 10 10 10 10 10 10 13  2  2  2  2  2  2  2
 2  2  2  2  2  2  8 31 30 30 30 30 30 31  9 10 10 10 11 31  0  0  1  0  0  0  0  9 10 10 10 11 31  0 25 23 23 23 23 23 23 26  7  2  2  3  2  2  2  2
 2  2  3  2  2  2  8 31 30 29 29 29 30 31 31 31 31 31 31 31  0  4  5  5  5  6  0 31 31 31 31 31 31 31 21 16 16 16 16 16 16 20  7  2  2  2  2  2  2  2
 2  2  2  2  2  2  8 31 30 29 29 29 30 31 31 31 31 31 31 31  0  7  2  2  2  8  0 31 31 31 31 31 31 31 21 16 16 16 16 16 16 20  7  2  2  2  2  2  2  2
 2  2  2  3  2  2  8 31 30 29 29 29 30 31 31 31 31 31 31 31  0  7  2  2  2  8  1 31 31 31 31 31 31 31 21 16 16 16 16 16 16 20  7  2  3  2  2  2  2  2
 2  2  2  2  3  2  8 31 30 29 29 29 30 31 31 31 31 31 31 31  0  9 10 10 10 11  0 31 31 31 31 31 31 31 21 16 16 16 16 16 16 20  7  2  2  2  2  2  2  2
 2  2  2  2  2  2  8 31 30 30 29 30 30 31 31 31 31 31 31 31  1  0 25 23 26  0  0 31 31 31 31 31 31 31 27 18 18 19 16 17 18 28  7  3  2  2  2  2  2  2
 2  2  2  2  2  2  8 31 31 31  0 31 31 31 31 31 31 31 31 31 31 31 21 16 20 31 31 31 31 31 31 31 31 31 31 31 31 21 16 20  4  5 15  2  2  2  2  2  2  2
 2  2  2  2  3  2  8 31 31 31  0 31 31 31 31 31 31 31 31 31 31 31 21 16 20 31 31 31 31 31 31 31 31 31 31 31 31 21 16 20  7  2  2  2  2  3  2  2  2  2
 2  2  2  2  2  2 14  5  6 31  0 31 31 31 31 31 31 31 31 31 31 31 21 16 20 31 31 31 31 31 31 31 31 31 31 31 31 21 16 20  7  2  2  2  2  2  2  2  2  2
 2  2  2  2  2  2  2  2  8 31  0 31 31 31 31 31 31 31 31 31 31 31 21 16 20 31 31 31 31 31 31 31 31 31 31 31 31 21 16 20  7  2  2  2  2  2  3  2  2  2
 2  2  3  2  2  2  2 12 11 31  0 31 31 31 31 31 31 31 31 31 31 31 21 16 20 31 31 31 31 31 31 31 31 31 31 25 23 24 16 20  7  2  2  3  2  2  2  2  2  2
 2  2  2  2  2  2  2  8  0  0  0 31 31 31 31 31 31 31 31 31 31 31 21 16 20 31 31 31 31 31 31 31 31 31 31 21 16 16 16 20  7  2  2  2  2  2  2  2  2  2
 2  2  2  3  2  2  2  8  0 31 31 31 31 31 31 31 31 31 31 31 31  0 21 16 20  0 31 31 31 31 31 31 31 31 31 21 16 17 18 28  7  2  3  2  2  2  2  2  2  2
 2  2  2  2  2  2  2  8  0 31 31 31  0 25 23 23 23 23 23 23 23 23 24 16 22 23 23 23 23 23 23 23 23 23 23 24 16 20  0 31  7  2  2  2  2  2  2  2  2  2
 2  2  2  2  2  3  2  8  0 31 31 31  1 21 16 16 16 16 16 16 16 16 16 16 16 16 16 16 16 16 16 16 16 16 16 16 16 20  0  4 15  2  2  2  2  2  2  2  2  2
 2  2  2  2  2  2  3  8  0  0 31 31  0 27 18 18 18 18 18 18 18 18 19 16 17 18 18 18 18 18 18 18 18 18 18 19 16 20  0  7  2  3  2  2  2  2  2  2  2  2
 2  2  2  2  2  2  2 14  6  0 31 31  0 31 31 31 31 31 31 31 31  0 21 16 20  0 31 31 31 31 31 31 31 31 31 21 16 20  0  7  2  2  2  2  3  2  2  2  2  2
 2  2  2  2  2  2  2  2  8  0 31 31  0 31 31 31 31 31 31 31 31 31 21 16 20 31 31 31 31 31 31 31 31 31 31 21 16 20  1  7  2  2  2  2  2  2  2  2  2  2
 2  2  2  2  2  3  2 12 11  0 31 31  0  0  0 31 31 31 31 31 31 31 21 16 20 31 31 31 31 31 31 31 31 31 31 21 16 20  0  7  2  2  2  3  2  2  2  2  2  2
 2  2  2  2  2  2  2  8  0  0 31 31 31 31  0 31 31 31 31 31 31 31 21 16 20 31 31 31 31 31 31 31 31 31 31 21 16 20  0  7  2  2  2  2  2  2  2  2  2  2
 2  2  2  3  2  2  2  8  0 31 31 31 31 31  0 31 31 31 31 31 31 31 21 16 20 31 31  0 31 31 31 31 31 31 31 21 16 20  0  7  2  3  2  2  2  2  2  2  2  2
 2  2  2  2  2  2  2  8  0 31 31 31 31 31  0 31 31 31 31 31 31 31 21 16 20 31 31 31 31 31  0 31 31 31 31 21 16 20  0  7  2  2  2  2  2  2  2  2  2  2
 2  2  2  2  2  2  3  8  0  0  0  0  0  0  0 31 31 31 31 31 31 31 21 16 20 31 31 31 31 31  0 31 31 31 31 27 18 28  0  7  2  2  2  2  3  2  2  2  2  2
 2  2  2  2  2  2  2  8  0  0  1  0  0  0  0 31 31 31 31 31 31 31 21 16 20 31 31 31 31 31 31 31 31 31 31 31  0 31  4 15  2  2  3  2  2  2  2  2  2  2
 2  2  2  2  2  2  2 14  6  0  0  0  0  0  0 31 31 31 31 31 31 31 21 16 20 31 31 31 31 31 31 31 31 31 31  0  0  0  7  2  2  2  2  2  2  2  2  2  2  2
 2  2  2  2  2  3  2  2  8  0  0  0  0  1  0 31 31 31 31 31 31 31 21 16 20 31 31 31 31 31 31 31 31 31 31  0  0  0  7  2  2  2  2  2  2  2  3  2  2  2
 2  2  2  2  2  2  2  2  8  1  0  0  0  0  0 31 31 31 31 31 31 31 21 16 20 31 31 31 31 31 31 31 31 31 31  0  0  1  7  2  2  3  2  2  2  2  2  2  2  2
 2  2  2  2  2  2  2  2  8  0  0  0  0  0  0 31 31 31 31 31 31 31 21 16 20 31 31 31 31 31 31 31 31 31 31  0  0  0  7  2  2  2  2  2  2  2  2  2  2  2
 2  2  2  2  3  2  2 12 11 31 31 31 31 31 31 31 31 31 31 31 31 31 27 18 28 31 31 31 31 31 31 31 31 31 31  1  0  0  9 13  2  2  2  2  2  2  2  2  2  2
 2  2  2  2  2  2  2  8 31 31 31 31 31 31 31 31 31 31 31  0  0  0  0  0  0  0  0 31 31 31 31 31 31 31  0  0  0  0  0  9 13  2  2  2  3  2  2  2  2  2
 2  2  2  2  2  2  3  8 31 31 31 31 31 31 31 31 31 31  0  0  0  0  0  0  0  0  0  0 31 31  0 31 31  0  0  0  0  0  0  0  7  2  2  2  2  2  2  2  2  2
 2  2  2  2  2  2  2  8  0 31 31 31 31 31 31 31 31 31  0  1  0  0  0  0  0  1  0  0 31 31 31 31  0  0  0  0  0  1  0  0  7  2  3  2  2  2  2  2  2  2
 2  2  2  2  2  2  2  8  0 31 31 31 31  0 31 31 31 31  0  0  1  0  0  0  0  0  0  0  0 31 31 31  0  0  0  0  0 31  0  0  7  2  2  2  2  2  2  2  2  2
 2  2  3  2  2  2  2  8  0 31 31 31 31 31 31 31 31 31  0  0  0  0  0  0  0  0  0  0  0  0  0  0  0  0 31  0  0  0  0  0  7  2  2  2  2  3  2  2  2  2
 2  2  2  2  2  2  2  8  0 31 31 31 31  0 31  4  5  5  6  0  0  0  0  0  1  0  0  4  5  5  6  0  0  0  0  0  0  0  1  0  7  2  2  2  2  2  2  3  2  2
 2  2  2  2  2  2  2  8 31 31 31 31 31 31  4 15  2  2 14  6  0  0  0  0  0  0  4 15  2  2  8  0  0 31  0  0 31  0  0  0  7  2  2  2  2  2  2  2  2  2
 2  2  2  2  3  2  2 14  5  5  5  5  5  5 15  2  2  2  2 14  5  5  5  5  5  5 15  2  3  2 14  6  0  1  0  0  0  0  4  5 15  2  3  2  2  2  2  2  2  2
 2  2  2  2  2  2  2  2  2  2  2  2  2  2  2  2  2  2  3  2  2  2  2  2  2  2  2  2  2  2  2 14  5  5  5  5  5  5 15  2  2  2  2  2  2  2  3  2  2  2
 2  2  2  2  2  2  2  2  2  2  2  3  2  2  2  2  3  2  2  2  2  2  2  2  2  2  2  2  2  2  2  2  2  2  2  2  3  2  2  2  2  2  2  3  2  2  2  2  2  2
 2  2  2  2  2  2  3  2  2  2  2  2  2  2  2  2  2  2  2  2  2  2  2  2  3  2  2  2  2  3  2  2  2  2  2  2  2  2  2  2  2  2  2  2  2  2  2  2  2  2
 2  2  2  2  2  2  2  2  2  2  2  2  2  2  3  2  2  2  2  2  3  2  2  2  2  2  2  2  2  2  2  2  3  2  2  2  2  2  2  3  2  2  2  2  2  2  2  2  2  2
 2  2  2  2  2  2  2  2  2  2  2  2  2  2  2  2  2  2  2  2  2  2  2  2  2  2  2  3  2  2  2  2  2  2  2  2  2  2  2  2  2  2  2  2  2  3  2  2  2  2
 2  2  2  2  2  2  2  2  2  2  2  2  2  2  2  2  2  2  2  2  2  2  2  2  2  2  2  2  2  2  2  2  2  2  2  2  2  2  2  2  2  2  2  2  2  2  2  2  2  2